SAN BORJA = SAN BORJA
JESUS MARIA = JESUS MARIA
PACHACAMAC = PACHACAMAC
SAN LUIS = SAN LUIS
LA MOLINA = LA MOLINA
ANCON = ANCON
VILLA EL SALVADOR = VILLA EL SALVADOR
SANTIAGO DE SURCO = SANTIAGO DE SURCO
ATE = ATE
CALLAO = CALLAO
LOS OLIVOS = LOS OLIVOS
LURIGANCHO = LURIGANCHO
COMAS = COMAS
VENTANILLA = VENTANILLA
SANTA ROSA = SANTA ROSA
PUENTE PIEDRA = PUENTE PIEDRA
CARMEN DE LA LEGUA REYNOSO = CARMEN DE LA LEGUA REYNOSO
CIENEGUILLA = CIENEGUILLA
PUCUSANA = PUCUSANA
LINCE = LINCE
RIMAC = RIMAC
CHACLACAYO = CHACLACAYO
SURQUILLO = SURQUILLO
MIRAFLORES = MIRAFLORES
LA PUNTA = LA PUNTA
PUEBLO LIBRE = PUEBLO LIBRE
SANTA ANITA = SANTA ANITA
LA PERLA = LA PERLA
SAN MIGUEL = SAN MIGUEL
LA VICTORIA = LA VICTORIA
BELLAVISTA = BELLAVISTA
CARABAYLLO = CARABAYLLO
BREÑA = BREÑA
LURIN = LURIN
SAN BARTOLO = SAN BARTOLO
SANTA MARIA DEL MAR = SANTA MARIA DEL MAR
PUNTA HERMOSA = PUNTA HERMOSA
PUNTA NEGRA = PUNTA NEGRA
BARRANCO = BARRANCO
CHORRILLOS = CHORRILLOS
SAN JUAN DE MIRAFLORES = SAN JUAN DE MIRAFLORES
VILLA MARIA DEL TRIUNFO = VILLA MARIA DEL TRIUNFO
MI PERÃz = MI PERÃz
LIMA = LIMA
EL AGUSTINO = EL AGUSTINO
INDEPENDENCIA = INDEPENDENCIA
SAN MARTIN DE PORRES = SAN MARTIN DE PORRES
SAN JUAN DE LURIGANCHO = SAN JUAN DE LURIGANCHO
MAGDALENA DEL MAR = MAGDALENA DEL MAR
SAN ISIDRO = SAN ISIDRO
